10 27
###########################
#>.....#..b.####b.........#
#............####...b...#.#
#.....h#......##........#Q#
########....b...........###
#.........#.....g.........#
#......b.....#####........#
#hh..........#bgh#....b...#
#hh.............b#.......h#
###########################